PRL = "countries/Pridelands.txt"
WLD = "countries/Wildlands.txt"
WSL = "countries/Wastelands.txt"
INS = "countries/Insects.txt"
LLA = "countries/Llamas.txt"
EMU = "countries/EmuEmpire.txt"
KAN = "countries/KangarooEmpire.txt"
FSH = "countries/Fish.txt"
LMR = "countries/Lemurs.txt"
SPB = "countries/Springbokia.txt"
ZBK = "countries/ZebraKingdom.txt"
GFK = "countries/GiraffeKingdom.txt"
ABL = "countries/AfricanBuffalo.txt"
GRT = "countries/GorillaTerritories.txt"
AEL = "countries/AfricanElephants.txt"
HYH = "countries/HyenaHighlands.txt"
RNE = "countries/RhinoEmpire.txt"
CMR = "countries/CamelRoutes.txt"
EPC = "countries/EgyptianCats.txt"
CMC = "countries/CamelConfederacy.txt"
GWV = "countries/GrayWolves.txt"
DLN = "countries/Dolphins.txt"
COW = "countries/Cows.txt"
MTG = "countries/MountainGoats.txt"
RTR = "countries/Roosters.txt"
BLL = "countries/Bulls.txt"
FRG = "countries/Frogs.txt"
VKD = "countries/VikingDogs.txt"
BDE = "countries/BaldEagles.txt"
ALG = "countries/Alligators.txt"
SQR = "countries/Squirrels.txt"
BFH = "countries/BuffaloHorde.txt"
PDT = "countries/PrarieDogTribe.txt"
BRC = "countries/BearConfederacy.txt"
CCH = "countries/CaucasianHorses.txt"
PSC = "countries/PersianCats.txt"
PLB = "countries/PolarBears.txt"
HRH = "countries/HorseHordes.txt"
IDT = "countries/IndianTigers.txt"
DRK = "countries/DrukEmpire.txt"
PSK = "countries/PitSnakes.txt"
CRC = "countries/CraneConfederacy.txt"
CNP = "countries/ChinesePandas.txt"
TAE = "countries/ThaiElephants.txt"
WTB = "countries/WaterBuffalo.txt"
GTC = "countries/GreenTurtleCouncil.txt"
KMD = "countries/KomodoDragons.txt"
PEN = "countries/Penguins.txt"
CMW = "countries/Commonwealth.txt"